####################
#******************#
#******************#
#*****########*****#
#*****########*****#
#*****########*****#
******########*****#
******########*****#
#*****########*****#
#*****########*****#
#*****########*****#
#******************#
#******************#
####################
