####################
####**********#*####
###***********#**###
w*************#****e
w*************#****e
##########****######
w********##********e
w*********##*******e
########***#########
w******#***********e
w******#*****#*****e
###****#*****#***###
####***#*****#**####
#########ss#########
