#########nn#########
####************####
###**************###
##****##**********##
#*****##***********#
#***######*********#
w***######*********#
w******************#
#*********######***#
#*********######***#
##**********##****##
###*********##***###
####************####
#########ss#########
