#########**#########
##****************##
#******************#
#****###****###****#
#****###****###****#
#****###****###****#
#*******************
#*******************
#****###****###****#
#****###****###****#
#****###****###****#
#******************#
##****************##
####################
