#########NN#########
#                  #
#########  #########
#                  #
#                  #
#      ######      #
#    ##########    E
#      ######      E
#      ######      #
#                  #
#                  #
#                  #
#                  #
####################
