####################
#******************#
#******************#
#******************#
#******************#
#******************#
W******************#
W******************#
#******************#
#******************#
#******************#
#******************#
#******************#
####################
