#########**#########
##****************##
#******************#
##############*****#
#************####**#
#*****#******#*****#
#*****#******#*****#
#**####******#*****#
#*****#************#
#*****##############
#******************#
#******************#
##****************##
#########**#########
