####################
####****#*******####
###*****#********###
##******#***########
#***#***#**********#
#***#***#**********#
****#***#***########
****#***#**********#
#***#***#**********#
#***#**************#
##**#*************##
###*#************###
#####***********####
#########**#########
