####################
####************####
###**************###
##****************##
#******************#
#******************#
#*******************
#*******************
#******************#
#******************#
##****************##
###**************###
####************####
####################
