########**##**######
*****#*****#****####
###*##*****#*****###
**#*#******#******##
**#*#**##**#*******#
#*#*#**#***#*******#
**#*#**#***#********
**#*#**#***#********
#*###**#############
********************
********************
###******#*******###
####*****#******####
####################
