#########**#########
#******************#
##################*#
#****************#*#
#*##############*#*#
#***********#**#*#*#
#**###******#**#*#*#
#*****#*****#**#*#*#
#******#****#**#*#*#
#*******#**#***#*#*#
#*********#****#*#*#
#**************#*#*#
#**************#***#
#########**#########
