#########NN#########
#******************#
#########**#########
#******************#
#******************#
#******######******#
#****##########****E
#******######******E
#******######******#
#******************#
#******************#
#******************#
#******************#
####################
