#########NN#########
#                  e
#                  e
#                  e
#                  e
#      ######      e
#      ######      e
#      ######      e
#      ######      e
#                  #
#                  #
#                  #
#                  #
#ssssssssssssss#####
