####################
####************####
###**************###
##****************##
#**********####****#
#**********####****#
w**********####****#
w**********####****#
#***###########****#
#***###########****#
##****************##
###**************###
####************####
#########ss#########
