####################
####***********#####
###**************###
##****************##
#******************#
#******************#
w******************#
w******************#
#******************#
#******************#
##****************##
###**************###
####************####
####################
