#########**#########
####************####
###**************###
##**********###***##
#***********###****#
#****##########****#
*****##########****#
************###****#
#***********###****#
#***********###****#
##**********###***##
###**************###
####************####
#########**#########

