####################
####************####
###**************###
##**############**##
#***#**********#***#
#####**********#***#
w**************#***e
w**************#***e
#####**********#***#
#***#**********#***#
##**#####**#####**##
###*****#********###
####****#*******####
#########ss#########
