#####nn##nn##nn#####
####***##**##***####
###****##**##****###
w******##**##******#
w******##**##******#
#******##**#########
w**#***##**##******e
w**#***##**##******e
#**#***##**##******#
w**#***##**##******#
w**#***##**##******#
####***##**##****###
####***##**##***####
#########ss##ss#####
