#########nn#########
####************####
###**************###
##***#########****##
#****#*************#
#****#*******#######
#****#*******#*****e
#****#*******#*****e
#****#*******#*****#
#****#########*****#
##****************##
###**************###
####************####
####################
