####################
#******************#
#******************#
#******************#
#******************#
#******************#
*******************#
*******************#
#******************#
#******************#
#******************#
#******************#
#******************#
####################
