####################
####************####
###**************###
##****************##
#******************#
#******************#
W******************b
W******************b
#******************#
#******************#
##****************##
###****######****###
####************####
#########nn#########
