#########**#########
####***#************
###****#############
**************#*****
**************#*****
#####*********######
****####************
*******######*******
#####*******########
****#***************
****#******#********
###*#******#*****###
#####******#****####
####################
