#########NN#########
#*******************
#*******************
#*******************
#*******************
#******######*******
#******######*******
#******######*******
#******######*******
#******************#
#******************#
#******************#
#******************#
#**************#####
