#########nn#########
####************####
###**************###
##****************##
#******************#
#******************#
w******************e
w******************e 
#******************#
#******************#
##****************##
###**************###
####************####
####################
