#####**************#
#******************#
#******************#
#******************#
#******************#
*******######******#
*******######*******
*******######*******
*******######******#
*******************#
*******************#
*******************#
*******************#
####################
