####################
####************####
###**************###
##****************##
#******************#
#******************#
********************
********************
#******************#
#******************#
##******####******##
###****######****###
####************####
#########**#########
