#####NNNNNNNNNN#####
####            ####
###              ###
##                ##
#                  #
W                  E 
W                  E
W                  E
W                  E
#                  #
##                ##
###              ###
####            ####
#####SSSSSSSSSS#####
