#########NN#########
#                  #
################## #
#                # #
# ############## # #
#           #  # # #
#  ###      #  # # #
#     #     #  # # #
#      #    #  # # #
#       #  #   # # #
#         #    # # #
#              # # #
#              #   #
#########SS#########
