#########**#########
####************####
###**************###
##***#########****##
#****#*************#
#****#*******#######
#****#*******#******
#****#*******#******
#****#*******#*****#
#****#########*****#
##****************##
###**************###
####************####
####################
