####################
####************####
###**************###
##****************##
#**********####****#
#**********####****#
***********####****#
***********####****#
#***###########****#
#***###########****#
##****************##
###**************###
####************####
#########**#########
