#########**#########
####************####
#########********###
##****************##
#*****######*******#
#******************#
#*********#######**#
#******************#
#*****########*****#
#******************#
##########********##
###**************###
####*******#########
#########**#########
