#########**#########
####************####
###**************###
##****##****##****##
#*****##****##*****#
#*****##****##*****#
******##****##*****#
******##****##*****#
#*****##****##*****#
#******************#
##****************##
###**************###
####************####
####################
