#########nn#########
####************####
###**************###
##**********###***##
#***********###****#
#****##########****#
w****##########****#
w***********###****#
#***********###****#
#***********###****#
##**********###***##
###**************###
####************####
#########ss#########

