#########NN#########
####************####
###**************###
##***#***##***#***##
#****#***##***#****#
#****#***##***#****#
#****#***##***#****E
#****#***##***#****E
#****#***##***#****#
#****#***##***#****#
##***#***##***#***##
###**************###
####************####
####################
