####################
####************####
###**************###
##***###########**##
#****#*************#
#****#****##########
#****#**************
#****#**************
#****#*************#
#****########******#
##**********#*****##
###*********#****###
####********#***####
#########**#########
