#########NN#########
####            ####
###              ###
##   #   ##   #   ##
#    #   ##   #    #
#    #   ##   #    #
#    #   ##   #    E
#    #   ##   #    E
#    #   ##   #    #
#    #   ##   #    #
##   #   ##   #   ##
###              ###
####            ####
####################
