####################
#******************#
#******************#
#*****########*****#
#*****########*****#
#*****########*****#
E*****########*****#
E*****########*****#
#*****########*****#
#*****########*****#
#*****########*****#
#******************#
#******************#
####################
