#nnnnnnnnnnnnnn#####
#******************#
#******************#
#******************#
#******************#
#******######******e
#******######******e
#******######******e
#******######******e
#******************e
#******************e
#******************e
#******************e
#########rr#########
