####nn##nn##########
####***#**#*****####
###****#**#******###
####***#**#****#***e
#**#***####****#***e
#**#***********#####
w**#############***e
w******************e
#******************#
#******************#
##****************##
###**************###
####************####
####################
