#########nn#########
######********######
######********######
######********######
######********######
######********######
######********######
######********######
######********######
######********######
######********######
######********######
######********######
#########ss#########
