#########NN#########
####*************###
#####*************##
#*####*************#
#**####************#
#***####***********#
W****####**********#
W*****####*********#
#******####********#
#*******####*******#
#******************#
##****************##
###**************###
####################
