#####**##**##**#####
####***##**##***####
###****##**##****###
*******##**##******#
*******##**##******#
#******##**#########
***#***##**##*******
***#***##**##*******
#**#***##**##******#
***#***##**##******#
***#***##**##******#
####***##**##****###
####***##**##***####
#########**##**#####
