#########**#########
####************####
###**************###
##******************
#*******************
#*****##############
#######*************
#*******************
#****###############
#*******************
##******************
###****#############
####***##*******####
#####**##**#########
