########nn##nn######
w****#*****#****####
###*##*****#*****###
w*#*#******#******##
w*#*#**##**#*******#
#*#*#**#***#*******#
w*#*#**#***#*******e
w*#*#**#***#*******e
#*###**#############
w******************e
w******************e
###******#*******###
####*****#******####
####################
