#########nn#########
####************####
###**************###
##*****************e
#******************e
#*****##############
#######************e
#******************e
#****###############
#******************e
##*****************e
###****#############
####***##*******####
#####ss##ss#########
