####**##**##########
####***#**#*****####
###****#**#******###
####***#**#****#****
#**#***####****#****
#**#***********#####
***#############****
********************
#******************#
#******************#
##****************##
###**************###
####************####
####################
