####################
##****************##
#******************#
###########********#
#############******#
##########*********#
#*******************
#*******************
#*****************##
#****************###
#**************#####
#************#######
##*********#########
#########**#########
