####################
#### ##      ## ####
###              ###
##    ##    ##    ##
#                  #
#    ##  ##  ##    #
#       ####       #
#   ##   ##   ##   #
#   ##        ##   #
#   ############   #
##                ##
###              ###
####            ####
#########SS#########
