####################
####*##******##*####
###**************###
##****##****##****##
#******************#
#****##**##**##****#
#*******####*******#
#***##***##***##***#
#***##********##***#
#***############***#
##****************##
###**************###
####************####
#########SS#########
