####################
*******************#
*******************#
*******************#
*******************#
*******######******#
*******######******#
*******######******#
*******######******#
#******************#
#******************#
#******************#
#******************#
#####**************#
