#########**#########
####********########
###*********########
##**********########
#***********########    
#******************#
#*******************
#*******************
#******************#
#******************#
##****************##
###**************###
####************####
####################
