#########NN#########
##                ##
#                  #
#    ###    ###    #
#    ###    ###    #
#    ###    ###    #
#                  E
#                  E
#    ###    ###    #
#    ###    ###    #
#    ###    ###    #
#                  #
##                ##
####################
