#########**#########
#******************#
#########**#########
#******************#
#******************#
#******######******#
#****##########*****
#******######*******
#******######******#
#******************#
#******************#
#******************#
#******************#
####################
