####################
####**********#*####
###***********#**###
**************#*****
**************#*****
##########****######
*********##*********
**********##********
########***#########
*******#************
*******#*****#******
###****#*****#***###
####***#*****#**####
#########**#########
