####################
####************####
###**************###
##**############**##
#***#**********#***#
#####**********#***#
***************#****
***************#****
#####**********#***#
#***#**********#***#
##**#####**#####**##
###*****#********###
####****#*******####
#########*##########
