#**************#####
#******************#
#******************#
#******************#
#******************#
#******######*******
*******######*******
*******######*******
#******######*******
#*******************
#*******************
#*******************
#*******************
#########**#########
