####################
#####******#****####
###*#******#*****###
##**#**#***#**#**###
#***#**#***#**#**#*#
#***#**#***#**#**#*#
****#**#***#**#**#**
****#**#***#**#**#**
#***#**#***#**#**#*#
#***#**#***#**#****#
##*****#******#***##
###****#******#**###
####***#******#*####
#########ss#########
