#########**#########
####************####
###**************###
##****##**********##
#*****##***********#
#***######*********#
****######*********#
*******************#
#*********######***#
#*********######***#
##**********##****##
###*********##***###
####************####
#########**#########
