####################
###**************###
##****************##
#***############***#
#******************#
#***############***#
#******************E
#***############***E
#******************#
#***############***#
#******************#
##****************##
###**************###
#########SS#########
