#########**#########
####*******#########
###**###############
##****************##
#################**#    
#******************#
#***################
#******************#
#################**#
#******************#
##*********#########
###********#########
####*******#########
#########**#########
