#########**#########
####************####
#######******#######
##****************##
#******************#
#****##########****#
#******************#
#******************#
#######******#######
#******************#
##****************##
###**##########**###
####************####
#########**#########
