#########**#########
####************####
###**************###
##***#***##***#***##
#****#***##***#****#
#****#***##***#****#
#****#***##***#*****
#****#***##***#*****
#****#***##***#****#
#****#***##***#****#
##***#***##***#***##
###**************###
####************####
####################
