#########nn#########
####********########
###*********########
##**********########
#***********########    
#******************#
#******************e
#******************e
#******************#
#******************#
##****************##
###**************###
####************####
####################
