####################
####************####
###**************###
##****************##
#****##########****#
#****##########****#
#****##########****e
#****##########****e
#****##########****#
#****##########****#
##****************##
###**************###
####************####
####################
