####################
###**************###
##****************##
#***############***#
#******************#
#***############***#
#*******************
#***############****
#******************#
#***############***#
#******************#
##****************##
###**************###
#########**#########
