####################
##           G    ##
#  X               #
###########        #
#############      #
##########         #
#                  E
#       G          E
#                 ##
#                ###
#              #####
#            #######
##         #########
#########SS#########
