#########NN#########
##****************##
#******************#
#****###****###****#
#****###****###****#
#****###****###****#
#******************E
#******************E
#****###****###****#
#****###****###****#
#****###****###****#
#******************#
##****************##
####################
