 11111111111111111111|22222222222222222222|33333333333333333333|44444444444444444444|55555555555555555555|
1                    |                    |                    |                    |                    |
1                    |                    |                    |                    |                    |
1                    |                    |                    |                    |                    |
1                    |                    |                    |                    |                    |
1                    |                    |                    |                    |                    |
1                    |                    |                    |                    |                    |
1                    |                    |                    |                    |                    |
1                    |                    |                    |                    |                    |
1                    |                    |                    |                    |                    |
1                    |                    |                    |                    |                    |
1                    |                    |                    |                    |                    |
1                    |                    |                    |                    |                    |
1                    |                    |                    |                    |                    |
1                    |                    |                    |                    |                    |
1                    |                    |                    |                    |                    |
----------------------------------------------------------------------------------------------------------
2                    |                    |                    |                    |                    |
2                    |                    |                    |                    |                    |
2                    |                    |                    |                    |                    |
2                    |                    |                    |                    |                    |
2                    |                    |                    |                    |                    |
2                    |                    |                    |                    |                    |
2                    |                    |                    |                    |                    |
2                    |                    |                    |                    |                    |
2                    |                    |                    |                    |                    |
2                    |                    |                    |                    |                    |
2                    |                    |                    |                    |                    |
2                    |                    |                    |                    |                    |
2                    |                    |                    |                    |                    |
2                    |                    |                    |                    |                    |
2                    |                    |                    |                    |                    |
----------------------------------------------------------------------------------------------------------
3                    |                    |                    |                    |                    |
3                    |                    |                    |                    |                    |
3                    |                    |                    |                    |                    |
3                    |                    |                    |                    |                    |
3                    |                    |                    |                    |                    |
3                    |                    |                    |                    |                    |
3                    |                    |                    |                    |                    |
3                    |                    |                    |                    |                    |
3                    |                    |                    |                    |                    |
3                    |                    |                    |                    |                    |
3                    |                    |                    |                    |                    |
3                    |                    |                    |                    |                    |
3                    |                    |                    |                    |                    |
3                    |                    |                    |                    |                    |
3                    |                    |                    |                    |                    |
----------------------------------------------------------------------------------------------------------
4                    |                    |                    |                    |                    |
4                    |                    |                    |                    |                    |
4                    |                    |                    |                    |                    |
4                    |                    |                    |                    |                    |
4                    |                    |                    |                    |                    |
4                    |                    |                    |                    |                    |
4                    |                    |                    |                    |                    |
4                    |                    |                    |                    |                    |
4                    |                    |                    |                    |                    |
4                    |                    |                    |                    |                    |
4                    |                    |                    |                    |                    |
4                    |                    |                    |                    |                    |
4                    |                    |                    |                    |                    |
4                    |                    |                    |                    |                    |
4                    |                    |                    |                    |                    |
----------------------------------------------------------------------------------------------------------
5                    |                    |                    |                    |                    |
5                    |                    |                    |                    |                    |
5                    |                    |                    |                    |                    |
5                    |                    |                    |                    |                    |
5                    |                    |                    |                    |                    |
5                    |                    |                    |                    |                    |
5                    |                    |                    |                    |                    |
5                    |                    |                    |                    |                    |
5                    |                    |                    |                    |                    |
5                    |                    |                    |                    |                    |
5                    |                    |                    |                    |                    |
5                    |                    |                    |                    |                    |
5                    |                    |                    |                    |                    |
5                    |                    |                    |                    |                    |
5                    |                    |                    |                    |                    |
----------------------------------------------------------------------------------------------------------
6                    |                    |                    |                    |                    |
6                    |                    |                    |                    |                    |
6                    |                    |                    |                    |                    |
6                    |                    |                    |                    |                    |
6                    |                    |                    |                    |                    |
6                    |                    |                    |                    |                    |
6                    |                    |                    |                    |                    |
6                    |                    |                    |                    |                    |
6                    |                    |                    |                    |                    |
6                    |                    |                    |                    |                    |
6                    |                    |                    |                    |                    |
6                    |                    |                    |                    |                    |
6                    |                    |                    |                    |                    |
6                    |                    |                    |                    |                    |
6                    |                    |                    |                    |                    |
----------------------------------------------------------------------------------------------------------
7                    |                    |                    |                    |                    |
7                    |                    |                    |                    |                    |
7                    |                    |                    |                    |                    |
7                    |                    |                    |                    |                    |
7                    |                    |                    |                    |                    |
7                    |                    |                    |                    |                    |
7                    |                    |                    |                    |                    |
7                    |                    |                    |                    |                    |
7                    |                    |                    |                    |                    |
7                    |                    |                    |                    |                    |
7                    |                    |                    |                    |                    |
7                    |                    |                    |                    |                    |
7                    |                    |                    |                    |                    |
7                    |                    |                    |                    |                    |
7                    |                    |                    |                    |                    |
----------------------------------------------------------------------------------------------------------
